############
#..#......T#
#..#.#####.#
#..#.....#.#
#..#####.#.#
#........#.#
########.#.#
#........#.#
#.########.#
#..........#
############
